#######
#.....#
#.#.#.#
#.#...#
#...#.#
#.###.#
#.....#
#######